9 9 9 9 9 9 9 9 9 9 9 9 9 9 9 9 9
9 9 9 9 9 9 9 9 9 9 9 9 9 9 9 9 9
9 9 9 9 9 9 9 9 9 9 9 9 9 9 9 9 9
9 9 9 9 9 9 9 9 9 9 9 9 9 9 9 9 9
9 9 9 9 9 9 9 9 9 9 83 46 46 46 46 84 9
9 9 9 9 9 9 9 9 9 9 48 0 0 0 0 47 9
9 9 9 9 9 9 9 9 9 9 48 0 0 0 0 47 9
9 9 9 9 9 9 9 9 9 83 0 0 0 0 0 47 9
9 9 9 9 9 9 9 9 9 48 0 0 0 0 0 0 
9 9 9 9 9 9 9 9 9 48 0 0 0 0 0 0
9 9 9 9 9 9 9 9 9 48 0 0 0 0 0 0
9 9 9 9 9 9 9 9 9 85 0 0 0 0 0 47 9
9 9 9 9 9 9 9 9 9 9 85 11 11 11 11 182 9