9 9 9 9 9 9 9 9 9 9 9 9 9 9 9 9 9
9 9 9 9 9 9 9 9 9 9 9 9 9 9 9 9 9
9 9 9 9 9 9 9 9 9 9 9 9 9 9 9 9 9
9 9 9 9 9 9 9 9 9 9 9 9 9 9 9 9 9
9 9 9 9 9 9 9 9 9 9 83 0 0 0 0 84 9
9 9 9 9 9 9 9 9 9 9 48 0 0 0 0 0 9
9 9 9 9 9 9 9 9 9 9 48 0 0 0 0 0 9
9 9 9 9 9 9 9 9 9 9 48 0 0 0 0 0 9
9 9 9 9 9 9 9 9 9 83 0 0 0 0 0 0 9
9 9 9 9 9 9 9 9 9 48 0 0 10 10 10 10 
9 9 9 9 9 9 9 9 9 48 0 0 10 10 10 10
9 9 9 9 9 9 9 9 9 48 0 0 10 10 10 10
9 9 9 9 9 9 9 9 9 85 0 0 0 0 0 47 9
9 9 9 9 9 9 9 9 9 9 85 11 11 11 11 86 9