9 9 9 9 9 9 9 9 9 9 9 9 9 9 9 9 9
9 9 9 9 9 9 9 9 9 9 9 9 9 9 9 9 9
9 9 9 9 9 9 9 9 9 9 9 9 9 9 9 9 9
9 9 9 9 9 9 9 9 9 9 9 9 9 9 9 9 9
9 9 9 9 9 9 9 9 9 9 0 0 0 0 0 0 9
9 9 9 9 9 9 9 9 9 9 0 0 0 0 0 0 9
9 9 9 9 9 9 9 9 9 9 0 0 0 0 0 0 9
9 9 9 9 9 9 9 9 9 9 0 0 0 0 0 0 9
9 9 9 9 9 9 9 9 9 0 0 0 0 0 0 0 9
9 9 9 9 9 9 9 9 9 0 0 0 10 10 10 10 
9 9 9 9 9 9 9 9 9 0 0 0 10 10 10 10
9 9 9 9 9 9 9 9 9 0 0 0 10 10 10 10
9 9 9 9 9 9 9 9 9 0 0 0 0 0 0 0 9
9 9 9 9 9 9 9 9 9 9 0 0 0 0 0 0 9