50 51 51 58 51 51 51 51 51 51 51 58 51 51 52
53 49 49 49 49 49 49 49 49 49 49 49 49 49 53
53 49 49 49 49 49 49 49 49 49 49 49 49 49 53
53 49 49 49 49 49 49 49 49 49 49 49 49 49 53
53 49 49 49 49 49 49 49 49 49 49 49 49 49 53
53 49 49 49 49 49 49 49 49 49 49 49 49 49 53
53 49 49 49 49 49 49 49 49 49 49 49 49 49 53
53 49 49 49 49 49 49 49 49 49 49 49 49 49 53
53 49 49 49 49 49 49 49 49 49 49 49 49 49 53
53 49 49 49 49 49 49 49 49 49 49 49 49 49 53
53 49 49 49 49 49 49 49 49 49 49 49 49 49 53
53 49 49 49 49 49 49 49 49 49 49 49 49 49 53
53 49 49 49 49 49 49 49 49 49 49 49 49 49 53
55 54 54 54 54 54 54 57 54 54 54 54 54 54 56
