50 51 51 58 51 51 51 51 51 59 51 58 51 51 52
53 49 49 49 49 49 49 49 49 53 61 63 63 64 53
53 49 49 49 49 49 49 49 49 53 62 71 71 65 53
53 49 49 49 49 49 49 49 49 53 62 71 71 65 53
53 49 49 49 49 49 49 49 49 53 69 70 71 65 53
53 49 49 49 49 49 49 49 49 55 52 69 68 66 53
53 49 49 49 49 49 49 49 49 49 55 51 52 67 53
53 49 49 49 49 49 49 49 49 49 49 49 60 54 53
53 49 49 49 49 49 49 49 49 49 49 49 49 49 53
53 49 49 49 49 49 49 49 49 49 49 49 49 49 53
53 49 49 49 49 49 49 49 49 49 49 49 49 49 53
53 49 49 49 49 49 49 49 49 49 49 49 49 49 53
53 49 49 49 49 49 49 49 49 49 49 49 49 49 53
55 51 51 51 51 51 51 57 51 51 51 51 51 51 56
