50 51 51 58 51 51 51 51 51 59 51 58 51 51 52
53 49 49 49 49 49 49 49 49 53 61 72 73 74 53
53 49 49 49 49 49 49 49 49 53 62 75 76 77 53
53 49 49 49 49 49 49 49 49 53 62 78 79 80 53
53 49 49 49 49 49 49 49 49 53 69 70 71 65 53
53 49 49 49 49 49 49 49 49 55 52 69 68 66 53
53 49 49 49 49 49 49 49 49 49 55 51 52 67 53
53 49 49 49 49 49 49 49 49 49 49 49 60 54 53
53 49 49 49 49 49 49 49 49 49 49 49 49 49 53
53 49 49 49 49 49 49 49 49 49 49 49 49 49 53
53 49 49 49 49 49 49 49 49 49 49 49 49 49 53
53 49 49 49 49 49 49 49 49 49 49 49 49 49 53
53 49 49 49 49 49 49 49 49 49 49 49 49 49 53
55 51 51 51 51 51 51 57 51 51 51 51 51 51 56
