3 0 0 0 0 0 0 0 0 0 0 0 159 158 158 158 158 158 156 0 0 89 88 88 88 88 88 86 0 0 103 102 102 102 102 102 100 0 0 117 116 116 116 116 116 114 0 0 131 130 130 130 130 130 128 0 0 145 144 144 144 144 144 142 0 0 6
3 0 0 0 0 0 0 0 0 0 0 0 160 170 171 172 173 174 157 0 0 90 88 88 88 88 88 87 0 0 104 102 102 102 102 102 101 0 0 118 116 116 116 116 116 115 0 0 132 130 130 130 130 130 129 0 0 146 144 144 144 144 144 143 0 0 6
3 0 0 0 0 0 0 0 0 0 0 0 168 166 167 161 166 167 169 0 0 98 96 97 91 96 97 99 0 0 112 110 111 105 110 111 113 0 0 126 124 125 119 124 125 127 0 0 140 138 139 133 138 139 141 0 0 154 152 153 147 152 153 155 0 0 6
3 0 0 0 0 0 0 0 0 0 0 0 162 164 165 12 164 165 163 0 0 92 94 95 12 94 95 93 0 0 106 108 109 12 108 109 107 0 0 120 122 123 12 122 123 121 0 0 134 136 137 12 136 137 135 0 0 148 150 151 12 150 151 149 0 0 6
3 0 0 0 0 0 0 0 0 0 0 0 0 0 0 0 0 0 0 0 0 0 0 0 0 0 0 0 0 0 0 0 0 0 0 0 0 0 0 0 0 0 0 0 0 0 0 0 0 0 0 0 0 0 0 0 0 0 0 0 0 0 0 0 0 0 6
49 49 49 71 71 0 0 0 0 0 0 0 0 0 0 0 0 0 0 0 0 0 0 0 0 0 0 0 0 0 0 0 0 0 0 0 0 0 0 0 0 0 0 0 0 0 0 0 0 0 0 0 0 0 0 0 0 0 0 0 0 0 0 0 0 0 6
3 0 0 0 0 0 0 0 0 0 0 0 0 0 0 0 0 0 0 0 0 0 0 0 0 0 0 0 0 0 0 0 0 0 0 0 0 0 0 0 0 0 0 0 0 0 0 0 0 0 0 0 0 0 0 0 0 0 0 0 0 0 0 0 0 0 6
3 0 0 0 0 0 0 0 0 0 0 0 0 0 0 0 0 0 0 0 0 0 0 0 0 0 0 0 0 0 0 0 0 0 0 0 0 0 0 0 0 0 0 0 0 0 0 0 0 0 0 0 0 0 0 0 0 0 0 0 0 0 0 0 0 0 6
3 0 0 0 0 0 0 0 0 0 0 0 0 0 0 0 0 0 0 0 0 0 0 0 0 0 0 0 0 0 0 0 0 0 0 0 0 0 0 0 0 0 0 0 0 0 0 0 0 0 0 0 0 0 0 0 0 0 0 0 0 0 0 0 0 0 6
4 5 5 5 5 5 5 5 5 5 5 5 5 5 5 5 5 5 5 5 5 5 5 5 5 5 5 5 5 5 5 5 5 5 5 5 5 5 5 5 5 5 5 5 5 5 5 5 5 5 5 5 5 5 5 5 5 5 5 5 5 5 5 5 5 5 8