9 9 9 9 9 9 9 9 9 9 9 9 9 9
9 9 9 9 9 9 9 9 9 9 9 9 9 9
9 9 9 9 9 9 9 9 9 9 9 9 9 9
9 9 9 9 9 9 9 9 9 9 9 9 9 9
9 9 9 9 9 9 9 9 9 9 9 9 9 9
9 9 9 9 9 9 9 9 9 9 9 9 9 9
9 9 9 9 9 9 9 9 9 9 9 9 9 9
9 9 9 9 9 9 9 9 9 9 9 9 9 9
46 46 46 46 46 84 9 9 9 9 9 9 9 9
0 0 0 0 0 47 9 9 9 9 9 9 9 9
0 0 0 0 0 47 9 9 9 9 9 9 9 9
0 0 0 0 0 47 9 9 9 9 9 9 9 9
0 0 0 0 0 47 9 9 9 9 9 9 9 9
11 11 11 11 11 182 9 9 9 9 9 9 9 9
9 9 9 9 9 9 9 9 9 9 9 9 9 9
9 9 9 9 9 9 9 9 9 9 9 9 9 9
9 9 9 9 9 9 9 9 9 9 9 9 9 9