50 51 51 51 51 51 51 51 51 51 51 51 51 51 52
53 49 49 49 49 49 49 49 49 49 49 49 49 49 53
53 49 49 49 49 49 49 49 49 49 49 49 49 49 53
53 49 49 49 49 49 49 49 49 49 49 49 49 49 53
53 49 49 49 49 49 49 49 49 49 49 49 49 49 53
53 49 49 49 49 49 49 49 49 49 49 49 49 49 53
53 49 49 49 49 49 49 49 49 49 49 49 49 49 53
53 49 49 49 49 49 49 49 49 49 49 49 49 49 53
53 49 49 49 49 49 49 49 49 49 49 49 49 49 53
53 49 49 49 49 49 49 49 49 49 49 49 49 49 53
53 49 49 49 49 49 49 49 49 49 49 49 49 49 53
53 49 49 49 49 49 49 49 49 49 49 49 49 49 53
53 49 49 49 49 49 49 49 49 49 49 49 49 49 53
55 51 51 51 51 51 51 57 51 51 51 51 51 51 56